R 1080 860
NO ./pics/bob_omb.xpm
SO ./pics/mountain_painting.xpm
WE ./pics/star_door.xpm
EA ./pics/fortress_painting.xpm

S                   ./pics/carapace64.xpm
F 188,201,205
C 0,185,255
  

            1111111111111111101111111111111111
            10000000000000000110000000100000001
            1000000000000000000000000000000000111111111111111111111111
            1000000000000001000000000000003200000000000000000000000001
111111111111130000000000001 10000000E000000000000000000000000000000001
1000000000000000000000000001000000000000000000000000000000000000000001
1000000000000000000000000000200000000000000000100001111111111111111111
1000000000000000000000000000000000000000000000111101
1000000011111111111111111111111111100000000000000001
100000000300000000000000000000003000000000000111111
11101111111111111111111111111111111111111111111
11101                                      101
11101                                      101
10001                                      101
10001                                      101
1000111111111111111111111111111111111111111101
1000000000000000000000000000000000000000000001
1101111111111111111111111111111111111111111111
 101
 101
 10111
 100001
 100001
 111111